BBBBBBBB
BSSSSSSB
B......B
B..EE..B
BU....UB
BBBBBBBB
